....................................................................................
....................................................................................
....................................................................................
....................................................................................
....................................................................................
..........##..##..$##...........................##........................##.......
.........##....#####......######...###.....#.#.#...........#...#####...#####........
.....@...#....$...........$.#........#.........$#.......$#####....$#................
####################################################################################
####################################################################################