....................................................................................
....................................................................................
...................##..........................##.................$........##.......
........###.....#####.......#.......###.....#####...............###.....#####.......
.....@.......$#...........$###......#.........$#.......$#####.........................
####################################################################################
####################################################################################